border_size=1
usage=map

Mm^Xm, Mm^Xm, Mm^Xm, Mm^Xm, Mm^Xm, Xu, Xu, Xu, Xu, Xu, Xu, Xu, Xu, Xu, Xu, Xu, Xu, Xu, Xu, Xu, Xu, Xu, Xu, Xu, Xu, Xu, Xu, Xu, Xu, Xu, Xu, Xu, Xu, Xu, Xu, Xu, Xu, Xu, Xu, Xu, Xu, Xu, Xu, Xu, Xu, Xu, Xu, Xu, Xu, Xu, Xu, Xu, Xu, Xu, Xu, Xu, Xu, Xu, Xu, Xu, Xu, Xu, Xu, Xu, Xu, Xu, Qxu, Xu, Xu, Xu, Xu, Gg
Mm^Xm, Mm^Xm, Mm^Xm, Mm^Xm, Mm^Xm, Mm^Xm, Xu, Xu, Xu, Xu, Ur, Xu, Xu, Xu, Xuc, Xu, Xuc, Xu, Xu, Xu, Xu, Xu, Ur, Xu, Uu^Uf, Xu, Uu^Uf, Xu, Xu, Xu, Uu^Vud, Xu, Xu, Xu, Xu, Xu, Xu, Xu, Xu, Xu, Xu, Xu, Uh, Xu, Xu, Xu, Xu, Xu, Xu, Xu, Xu, Xu, Xu, Xu, Xu, Xu, Xuc, Xuc, Xuc, Xuc, Xu, Xu, Xu, Xu, Xu, Xu, Qxu, Xu, Qxu, Xu, Xu, Xu
Mm^Xm, Mm^Xm, Mm^Xm, Mm^Xm, Mm^Xm, Mm^Xm, Xu, Xu, Ur, Rd, Xuc, Ur, Uu, Uue, Ur, Xu, Xuce, Xuc, Ur, Xu, Uu, Ur, Xu, Ur, Ur, Ur, Ur, Ur^Y27, Uu, Ur, Uu, Uu, Uu, Xu, Xu, Xu, Xu, Xu, Xu, Xu, Xu, Uh, Xu, Uh, Uu, Uh, Xu, Xu, Xu, Xu, Qxu, Xu, Qxu, Xu, Xuc, Xuc, Xuc, Xuc, Cud, Xuc, Xuc, Xu, Xu, Xu, Qxu, Qxu, Xu, Xu, Qxu, Xu, Xu, Xu
Mm^Xm, Mm^Xm, Mm^Xm, Mm^Xm, Mm^Xm, Mm^Xm, Ur, Ur, Xu, Xu, Xu, Xuc, Xuc, Xuc, Uu^Emf, Ur, Ur, Ur, Xu, Rb, Uu, Xu, Xu, Xu, Xu, Uu, Uu, Ur, Xu, Xu, Xu, Ur, Ur, Ur, Uu, Uu^Vud, Xu, Xu, Xu, Xu, Xu, Xu, Xu, Uh, Xu, Xu, Xu, Xu, Qxu, Qxu, Xu, Qxu, Qxu, Qxu, Kud, Xuc, Rr^yyLB, Cud, 4 Kud, Cud, Rr^yyLB, Xuc, Kud, Qxu, Qxu, Qxu, Xu, Xu, Qxu, Xu, Xu, Xu
Mm^Xm, Mm^Xm, Mm^Xm, Mm^Xm, Uu, Uue, Mm^Xm, Mm^Xm, Mm^Xm, Xu, Xu, Xu, Xu, Xuc, Xu, Xu, Uu^Emf, Xu, Xu, Xu, Ur, Ur^Y8, Ur^Y10, Xu, Xu, Xu, Xu, Ur, Ur, Xuce, Xuc, Xuc, Uu, Ur, Ur, Rb^Y26, Uu^Uf, Xu, Uu^Y5, Xu, Xuc, Xuc, Qxu, Uu, Xuc, Xu, Xu, Xu, Xu, Qxu, Qxu, Qxu, Qxu, Cud, Cud, Rr^yyLB, Rr, Rr, Rr, Rr, Rr, Rr^yyLB, Cud, Cud, Qxu, Qxu, Xu, Qxu, Xu, Xu, Xu, Xu
Mm^Xm, Mm^Xm, Mm, Md, Hh, Mm^Xm, Mm^Xm, Mm^Xm, Mm^Xm, Mm^Xm, Mm^Xm, Xu, Xu, Xu, Xu, Xu, Xu, Uue^Emf, Xuc, Xu, Xu, Uue^Y11, Xu, Xu, Xu, Xu, Xu, Uu^Vu, Ur, Re, Ur, Ur, Ur, Uu, Ur, Rb, Uu, Ur, Ur, Xu, 5 Kud, Xuc, Qxu, Uh, Ur^Y22, Xuc, Xuc, Xu, Xu, Xu, Qxu, Qxu, Qxu, Qxu, Kud, Rr, Rr, Rr, Rr, Rr, Rr, Rr, Kud, Qxu, Qxu, Qxu, Qxu, Xu, Xu, Xu, Xu, Xu
Mm^Xm, Mm^Xm, Mm^Xm, Mm^Xm, Hh, Mm, Mm, Mm^Xm, Mm^Xm, Mm^Xm, Mm^Xm, Mm^Xm, Mm^Xm, Xu, Xu, Xu, Xu, Xu, Xu, Xuc, Xu, Xu, Xu, Xu, Xu, Xu, Ur, Uu, Uue, Uu, Ur, Uu, Xu, Xu, Xu, Ur, Ur, Ur, Ur, Cud, Cud, Cud, Uu, Ur, Ur, Xuc, Xuc, Xuc, Uu^Vud, Xu, Xu, Xu, Qxu, Cud, Cud, Rr, Rr, Rr, Rr, Rr, Rr, Rr, Cud, Cud, Qxu, Xu, Qxu, Xu, Xu, Xu, Xu, Xu
Hh^Fp, Mm, Hh, Mm, Gll^Fp, Mm, Mm, Mm, Mm, Mm^Xm, Mm^Xm, Mm^Xm, Mm^Xm, Mm^Xm, Mm^Xm, Xu, Xu, Xu, Xu, Xuc, Xu, Xu, Uu, Ur, Uu, Ur, Uu, Re, Ur, Uu^Vu, Xu, Xu, Xu, Xu, Xu, Xu, Xuce, Uu, Uue, Ur, Ur, Ur, Ur, Rb, Uu, Ur, Ur, Uu, Ur, Xuc, Xuc, Xu, Qxu, Qxu, Kud, Rr, Rr, Rr, Rr, Rr, Rr, Rr, Kud, Qxu, Qxu, Qxu, Xu, Xu, Xu, Qxu, Xu, Xu
Hh^Fp, Hh, Hh^Fp, Gll^Fp, Gll^Fp, Gll^Fp, Hh, Mm, Mm, Mm^Xm, Mm, Mm^Xm, Mm, Mm^Xm, Mm^Xm, Mm^Xm, Mm^Xm, Xu, Xuce, Xuc, 2 Kud, Uu, Xu, Xu, Xu, Uue, Uu^Uf, Uue, Xu, Xuc, Xuc, Xu, Xu, Xu, Xu, Xu, Uu^Vud, Uue^Y22, Uu, Ur, Uue, Re, Xu, Uu, Uu, Ur, Uu, Ur, Ur, Ur, Ur, Uu, Qxu, Xu, Xuc, Xuc, Cud, Rr, Rr, Rr, Cud, Uu, Uu, Qxu, Qxu, Qxu, Xu, Xu, Qxu, Qxu, Xu, Xu
Mm^Xm, Hh, Hh^Fp, Hh, Gg, Hh, Hh^Fp, Mm, Mm, Mm, Mm, Mm, Mm, Mm, Mm, Mm^Xm, Mm, Xuce, Cud, Cud, Cud, Xuce, Xu, Xu, Xu, Xu, Xu, Xu, Xu, Xuc, Xuc, Uue, Xuc, Xu, Xu, Xu, Ur, Uu, Ur, Uu, Xuc, Xuc, Xuc, Uu, Uu^Vud, Xuc, Xu, Xu, Xu, Ur, Uu, Ur, Ur, Xuc, Xuc, Xuc, Xuc, Rr, Rr, Rr, Xuc, Xu, Xu, Uu, Uu, Qxu, Qxu, Xu, Qxu, Xu, Xu, Xu
Mm^Xm, Md, Hh^Fp, Gll^Fp, Gll^Fp, Gll^Fp, Hh, Hh, Hh, Hhd, Mm, Mm, Mm, Mm, Mm, Mm, Hh, Hhd^Y26, Gs, Rb, Cud, Xuce, Xu, Xu, Xu, Xu, Xu, Xu, Xu, Xuc, Xu, Uu, Uu, Xuc, Xuc, Xuc, Ur, Ur, Ur, Uu, Xuc, Xuc, Uu, Uu, Xu, Xu, Xu, Xu, Xu, Xu, Xu, Ur, Uu, Ur, Ur, Xuc, Rr, Rr, Rr, Rr, Xu, Xu, Xu, Xu, Xu, Uu, Qxu^Bs\, Qxu, Xu, Xu, Xu, Xu
Mm^Xm, Hh^Fp, Hh^Fp, Gll^Fp, Re, Gg, Gll^Fp, Gs, Gs, Hhd, Hh^Fp, Hh, Hh, Mm, Hh, Hh, Ds, Gs, Gg, Gs, Hh, Xuce, Mm^Xm, Xu, Xu, Xu, Xu, Xu, Xu, Xu, Xu, Xu, Xu, Uu, Uu, Uu, Xuc, Ur, Ur, Uu, Uu, Uu, Uu, Xu, Xu, Xu, Xu, Xu, Ur, Xuce, Xu, Xu, Xu, Ur, Ur, Ur, Ur, Rr, Ur, Rr, Ur, Uu^Vud, Uu^Vud, Xu, Xu, Uu, Qxu, Uu, Uu, Xu, Xu, Xu
Mm^Xm, Md, Hh^Fp, Hh^Fp, Hh^Fp, Gll^Fp, Gll^Fp, Gll^Fp, Ds, Gs, Ds, Gs, Hh^Fp, Hh, Ds, Gg, Gg, Gg, Gg, Gg, Hh, Hhd^Dr, Mm, Mm^Xm, Mm^Xm, Xu, Xu, Xu, Xu, Xu, Xu, Xu, Xu, Xu, Xuc, Xuc, Xu, Uu^Y22, Uu, Ur, Uu, Uu^Y22, Ur, Xu, Xu, Xu, Ur, Xu, Xu, Uue, Ur^yyP/, Xu, Xu, Xu, Xu, Uu, Xu, Ur, Xu, Ur, Ur, Uu, Uu^Uf, Xu, Xu, Xu, Xu, Qxu, Uu, Xu, Xu, Xu
Mm^Xm, Md, Gll^Fp, Hh^Fp, Gg, Hh^Fp, Re, Gll^Fp, Gg, Gg, Ds, Gg, Gll^Fp, Hh, Ds, Gg, Gg, Gg, Gg, Gg, Hh, Mm, Mm, Mm, Mm, Mm^Xm, Mm^Xm, Xu, Xu, Xu, Xu, Xu, Xu, Xu, Xu, Xu, Xu, Xu, Xu, Uu, Ur, Uu, Ur, Xuc, Xuce, Xu, Xu, Uu^Xo, Ur^Xo, Xu, Ur, Ur, Ur^yyP/, Xu, Xu, Xu, Xu, Xu, Qxu, Ur, Uh, Uu, Ur, Uu, Uu^Uf, Xu, Xu, Qxu, Qxu^Bs|, Qxu, Qxu, Qxu
Aa, Md, Hh^Fp, Gll^Fp, Re, Gg, Gll^Fp, Re, Gll^Fp, Re, Gg, Re, Gg, Gll^Fp, Hh^Fp, Gg, Gg, Gg, Gg, Rb, Hh, Mm, Mm, Mm, Mm, Mm, Mm, Mm^Xm, Mm^Xm, Xu, Xu, Xu, Xu, Xu, Xu, Xu, Uu^Y11, Xu, Ur^Dr, Uu, Xu, Uu, Uu, Uu, Uue, Xu, Xu, Xu, Ur, Uu, Xuc, Xu, Xu, Uu, Ur, Xu, Xu, Qxu, Qxu, Uu, Uh, Xuc, Xu, Ur, Ur, Uh, Cud, Cud, 6 Kud, Qxu, Xuce, Xu
Ha^Fma, Ha^Fma, Aa, Gll^Fp, Hh^Fp, Re, Gg, Gg, Gg, Gg, Gll^Fp, Re, Gg, Hh^Fp, Rd, Gg, Re, Gg^Es, Gg, Gg, Gd, Hh^Fp, Hh, Mm, Mm, Mm, Mm, Mm, Mm, Mm^Xm, Mm^Xm, Xu, Xu, Xu, Xu, Uu^Y11, Uu, Uu, Uu, Xu, Xu, Xuc, Xuc, Uu, Uu, Uu, Ur, Ur^Xo, Xu, Xu, Xu, Xuc, Xuc, Xu, Xu, Xu, Xu, Uh, Ur, Ur, Uh, Xu, Xu, Xu, Uu, Uu, Uu, Cud, Cud, Cud, Xu, Xu
Aa, Aa^Fpa, Hhd^Vhhr, Gll^Fp, Aa, Gg, Gg, Gg, Gg, Re, Gg, Gg, Rb, Gg, Gg, Gg, Gg, Re, Gg, Gg, Gg, Hh, Hh, Mm, Mm, Mm, Mm, Mm, Mm, Mm, Mm^Xm, Mm^Xm, Mm^Xm, Xu, Xu, Xu, Ur^Y22, Ur^Dr, Uu^Y11, Uu^Y11, Xu, Xuc, Xuc, Uu^Y27, Uu, Ur, Ur, Ur, Ur, Xu, Xu, Xu, Xuc, Xuc, Xuc, Xu, Ur, Uu, Qxu, Uh, Xu, Xu, Xu, Xu, Uu^Vud, Ds, Uh^Dr, Uh, Uu, Ur, Uu^Vud, Xu
Aa^Fpa, Aa, Aa, Rb, Gg, Aa, Re, Gg, Gg, Gll^Fp, Hh, Hh^Fp, Hh^Fp, Hh, Gg, Re, Gg, Gg, Gg, Gg, Gg, Gg, Rb, Hhd, Hhd, Hh, Mm, Mm, Mm, Mm, Mm, Mm, Mm, Mm^Xm, Mm^Xm, Ur^Y22, Xu, Xu, Xu, Xu, Xu, Xu, Xu, Xuc, Xu, Uu^Vu, Uu, Ur, Re, Uu, Ur, Xu, Xuc, Xuc, Ur, Uu, Uu, Qxu, Uu^Emf, Xuc, Xuc, Xu, Xu, Xu, Uu, Uu, Hhd^Y22, Uu^Vud, Ur, Ur^Es, Uu^Uf, Xu
Ha, Ha, Aa^Fpa, Rb, Aa, Gg, Gg, Gg, Hh, Hhd, Md, Hh^Fp, Md, Hh, Gs, Gg, Rd, Gg, Gg, Gg, Re, Gg, Gg, Gs, Gs, Hh, Hh, Mm, Hh^Fp, Mm, Mm, Mm, Hh, Hh, Hh, Mm^Xm, Xu, Xu, Xu, Xu, Xu, Xu, Xu, Xu, Xu, Xuc, Xu, Uu, Ur, Ur, Uu, Uu, Uu, Uue, Uu, Uu, Xuc, Qxu, Uu, Uu^Vud, Uh^Dr, Xu, Xu, Xu, Ur, Uu, Uu, Uu, Uu, Uu, Uu, Uu
Ms, Ha^Vhha, Ha, Aa, Gd, Gg, Gd, Gg, Hh, Hh^Fp, Mm, Hhd, Md, Hh, Hh^Fp, Ds, Rb, Rd, Gs, Gg, Gg, Re, Gg, Gg, Gg, Hh^Fp, Hh^Fp, Hh, Hhd, Hh^Fp, Hh^Fp, Hh^Fp, Mm, Mm, Hh, Mm^Xm, Mm^Xm, Xu, Xu, Xu, Xu, Xu, Xu, Xu, Xu, Xu, Xu, Cud, Kud, Uu, Uu, Uu, Ur, Ur, Cud, Xuc, Xuc, Qxu, Uu, Ur, Uu^Vud, Uh, Uu^Vud, Ur, Uu, Uu, Xu, Uh^Emf, Uh, Uu, Qxu, Qxu
Ms, Ms, Ha, Aa^Fpa, Aa^Fpa, Gg, Rb, Gg, Hh, Md, Mm, Mm, Md, Hh^Fp, Md, Hh^Fp, Hhd, Re, Rd, Rb, Gs, Gg, Gg, Gg, Gg, Gs, Rb, Gs, Hhd^Vhhr, Mm, Mm, Mm, Mm, Hh, Mm, Mm, Mm, Mm^Xm, Mm^Xm, Xu, Xu, Xu, Xu, Xu, Xu, Xu, Xu, Cud, Cud, Cud, Xuc, Ur, Uu, Ur, Ur, Cud, Cud, Qxu, Qxu, Uu, Uu, Ur, Ur, Ur, Uu^Vud, Xu, Xu, Xu, Uu, Uu, Qxu, Qxu
Ha, Ms, Ms, Ms, Aa^Fma, Rd, Rb, Aa, Aa^Fpa, Md, Mm, Hh, Md, Md, Gd^Vhr, Hh^Fp, Gg, Re, Re, Rd, Re, Gg, Gg, Gg, Gg, Gg, Gg, Gg, Rb, Hhd, Hh^Fp, Mm, Hh, Hh, Mm, Mm, Mm, Mm, Mm, Mm^Xm, Mm^Xm, Xu, Xu, Xu, Xu, Xu, Xu, Xu, Uu, Xuc, Xuc, Xuc, Xuc, Ur, Ur, Ur, Uue, Kud, Uu, Uh, Ur, Ur, Qxu, Uh, Xu, Xu, Uu^Vu, Uu^Y27, Uu, Uu, Uh^Emf, Xu
Ms, Ms, Ms, Aa^Fpa, Aa, Aa, Rb, Aa^Fpa, Ha^Fma, Ms, Mm, Md, Md, Md, Hh^Fp, Gg, Ce, Ce, Ce, Gs, Gg, Rd, Rd, Gg, Gg, Rb, Gg, Gg, Rb, Hh^Fp, Md, Md, Hh, Hh, Hh, Mm, Mm, Mm, Mm, Mm^Xm, Mm^Xm, Mm^Xm, Xu, Xu, Xu, Xu, Xu, Uu, Qxu, Xuc, Xuc, Xu, Re, Uu, Uu, Uu, Cud, Cud, Cud, Uu^Dr, Xu, Qxu, Qxu, Uh^Dr, Ur, Xu, Uu, Uu, Qxu, Ur, Xu, Xu
Ms, Aa^Fpa, Aa, Aa, Rb, Rd, Aa, Ha^Fpa, Ms, Md, Ms^Xm, Md, Ha^Fpa, Aa^Fda, Hh^Fp, Rb, Ce, 7 Ke, Ce, Rb, Rd, Gs, Gg, Gg, Gg, Gg, Gg, Rb, Gg, Hh^Fp, Md, Md, Hh^Fp, Gs, Gs, Hh, Hh^Fp, Mm, Mm, Mm, Mm, Mm^Xm, Mm^Xm, Xu, Xu, Xu, Xu, Xu, Cud, Cud, Uu, Ur^Y26, Uu, Uue, Uu^Vud, Xuc, Xu, Xu, Xuc, Cud, Xu, Xu, Uu, Qxu, Ur, Ur, Uu, Qxu, Ur, Ur, Xu, Xu
Ms, Ha^Fpa, Aa, Rd, Rb, Rb, Aa^Fpa, Aa^Fpa, Ha^Fpa, Ms^Xm, Md, Md, Ha, Aa, Ha^Fpa, Hhd^Y22, Rb, Ce, Rb, Re, Rb, Rd, Rb, Gg, Gg, Gg, Rb, Gg, Gg, Hh^Fp, Hh^Fp, Hh^Fp, Gg, Rb, Rb, Gg, Hh^Fp, Mm, Mm, Mm, Mm, Mm^Xm, Mm^Xm, Mm^Xm, Xu, Xu, Xu, Xu, Uu, Ur, Uu, Uu, Ur, Ur, Uh, Xuc, Xuc, Xuc, Xu, Uh^Y26, Uh^Y27, Cud, Ur, Uu, Uh, Uu, Uu^Vud, Qxu, Ur, Uu^Vud, Xu, Xu
Ha, Ha, Aa, Aa, Rb, Aa^Fpa, Ms, Aa^Fpa, Ms^Xm, Ms^Xm, Ms, Ha^Fpa, Aa^Vha, Ha, Ha^Fpa, Hh^Fp, Gg, Gg, Re, Gs, Rd, Gs, Rd, Gg, Gg, Gg, Gs, Gd, Gg, Gd, Gg, Gg, Rb, Rb, Gg, Gg, Hh, Hhd, Hh, Mm, Mm, Mm, Mm, Mm^Xm, Mm^Xm, Xu, Xu, Xu, Uu, Ur^Es, Ur, Ur, Uu, Uu, Ur, Uh^Emf, Uh, Xuc, Uh, Uh^Y27, Ur, Uu, Qxu, Qxu, Cud, Uh^Y27, Cud, Rd, Uh^Emf, Xu, Xu, Xu
Ha, Ha, Rb, 1 Rd, Aa, Ha, Ms, Ms, Ms^Xm, Ms^Xm, Ms^Xm, Ha, Aa, Ha, Aa^Fda, Aa, Gg, Re, Gg, Gg, Rd, Rb, Gg, Gd, Rb, Rb, Gg, Gg, Gg, Gg, Gg, Gg, Gg, Gg, Gg, Rb, Gg, Hh, Gg, Hh, Mm, Mm, Mm, Mm^Xm, Mm^Xm, Xu, Xu, Xuce, Uue, Ur, Xu, Xu, Xu, Ur^Y27, Ur, Uu, Ur, Uh, Rb, Ur, Qxu, Uh, Ur, Qxu, Uu, Kud, Xu, Xu, Xu, Xu, Xu, Xu
Aa, Aa, Aa, Rd, Aa, Aa^Fpa, Ms, Ms, Ms^Xm, Ms^Xm, Ms^Xm, Ha, Ms, Aa^Fda, Aa^Fda, Aa, Gs, Gg, Gg, Gg, Gg, Gg, Gg, Gg, Gg, Re, Gg, Gg, Gs, Gg, Gg, Gg, Gg, Gg, Gg, Gg, Gg, Gg, Gg, Hh, Hh, Mm, Mm, Mm^Xm, Mm^Xm, Xu, Xu, Uu, Ur, Xu, Xu, Xu, Xu, Xu, Rb, Uu, Ur^Y26, Ur, Ur, Qxu, Qxu, Xu, Xu, Ur, Uue, Uu, Uh, Xu, Xu, Xu, Xu, Xu
Aa, Rb, Aa, Aa, Ha, Aa^Fpa, Ms, Ms, Ms^Xm, Ms^Xm, Ms^Xm, Ms, Ha, Aa^Fda, Aa, Aa, Aa, Rb, Rb, Aa, Rb, Gg, Gg, Gg, Gg, Gs, Gs, Gs, Gg, Gg, Gg^Es, Gg, Gg, Gg, Gg, Gg, Gg, Gg, Gg, Gg, Gs, Hh, Cud, Xuce, Xuce, Xu, Xu, Ur, Re, Xu, Xu, Xu, Ur^yyB, Ur, Xu, Xu, Xu, Uu, Ur, Uu, Ur, Xu, Xu, Xu, Xu, Uu, Ur, Uu^Emf, Xu, Xu, Xu, Xu
Aa, Rd, Aa, Ha, Ms, Ms, Ms, Ms, Ms^Xm, Ms^Xm, Ms^Xm, Ms^Xm, Ms, Ha, Ha, Aa, Aa^Vha, Aa, Aa, Gs, Aa, Gg, Aa, Aa, Rb, Gg, Gg, Gs, Gs, Gg, Gg, Gg, Gg, Gg^Es, Gg, Gg, Gg, Gg, Gg, Gg, Gg, Gd, Rb, Cud, 3 Kud, Xu, Xuce, Ur, Ur^Es, Xuce, Xu, Xu, Rb^Y12, Uu, Ur^Y13, Xu, Xu, Xu, Xuc, Uu, Ur, Uu^Y27, Uh, Xu, Xu, Uh^Y27, Rd, Uu^Uf, Xuce, Xu, Xu, Xu
Aa, Aa, Ha, Ms, Ms, Ms, Ms, Ha, Ms^Xm, Ms^Xm, Ms^Xm, Ms^Xm, Ms^Xm, Ms, Ha^Fda, Ha, Ha, Rb, Aa, Aa, Aa, Gs, Gs, Aa, Ce, Ce, Ce, Gg, Gg, Gg, Gg, Gg, Gg, Gg, Gg, Gg, Gg, Gg, Gg, Gg, Gs, Gs, Cud, Cud, Xuce, Ur, Ur, Ur^Es, Xu, Xu, Xu, Xu, Ur^Y11, Ur, Ur^Y12, Ur^Y5, Ur^Y10, Xu, Xu, Qxu, Uu, Ur, Ur, Uu^Emf, Uu^Uf, Uh, Uu, Rd, Xu, Xu, Xu, Xu
Aa, Aa, Ha, Ha, Aa^Vha, Ha, Ms^Xm, Ms, Ms^Xm, Ms^Xm, Ms^Xm, Ms^Xm, Ms, Ms^Xm, Ms^Xm, Ms, Ha, Aa, Ha, Aa, Aa, Aa, Aa, Gs, Cea, 8 Ke, Ce, Gg, Gg, Gg, Gg, Re, Gg, Gg, Gg, Gg, Gg, Gg, Gg, Gg, Hh, Hh, Mm, Xuce, Xu, Xu, Xu, Xu, Xu, Xu, Xu, Ur^Y11, Ur^Y8, Ur^Y1, Ur^Y14, Ur^Y11, Xu, Xu, Xu, Qxu, Qxu, Uu, Uu^Dr, Ur, Ur, Uu^Emf, Uu, Ur, Xu, Xu, Xu, Xu
Ha, Ha, Ms^Xm, Ms, Ms, Ms, Ms, Ms, Ms, Ms^Xm, Ms^Xm, Ms^Xm, Ms, Ms^Xm, Ms^Xm, Ms, Ms, Ha, Ms, Ha, Gd, Gs, Aa, Aa, Aa, Cea, Aa, Gg, Gg, Gg, Gll^Fp, Gg, Gll^Fp, Gll^Fp, Re, Gg, Gg, Gg, Gg, Hh, Mm, Mm, Mm, Mm^Xm, Mm^Xm, Xu, Xu, Xu, Xu, Xu, Xu, Xu, Xu, Ur^Y14, Xu, Xu, Xu, Xu, Xu, Qxu, Qxu, Uu^Y27, Xu, Uu^Uf, Uu, Ur, Rd^Y29, Uu, Uu, Xu, Xu, Xu
Ms^Xm, Ms^Xm, Ms^Xm, Ms, Ms^Xm, Ha, Ha, Ha, Ms, Ms^Xm, Ms^Xm, Ms^Xm, Ms^Xm, Ms^Xm, Ms^Xm, Ms^Xm, Ms^Xm, Ms, Aa^Fpa, Aa^Vha, Ha, Ha, Aa^Fpa, Aa, Aa^Vca, Rb, Gd, Gg, Aa, Gg, Gg, Re, Gg, Gg, Gll^Fp, Gll^Fp, Gll^Fp, Gg, Hh^Fp, Hh, Mm, Mm, Mm, Mm^Xm, Mm^Xm, Xu, Xu, Xu, Xuc, Xuc, Xuc, Xuc, Xuc, Xuc, Xuc, Xu, Xu, Xu, Qxu, Qxu, Qxu, Xu, Xuc, Xu, Xu, Ur, 9 Ur^Es, Ur, Ur, Uu, Uu, Uu
Ms^Xm, Ms^Xm, Ms, Ms, Ms, Ms, Ms, Ms, Ms^Xm, Ms^Xm, Ms^Xm, Ms^Xm, Ms^Xm, Ms^Xm, Ms^Xm, Ms^Xm, Ms^Xm, Ms, Ha, Ms, Aa^Fpa, Ha, Aa^Fpa, Aa^Fpa, Aa, Aa, Rd, Gg, Gg, Aa, Aa, Gg, Gg, Gll^Fp, Gll^Fp, Gg, Gg, Gg, Hh, Hh, Mm, Mm, Mm^Xm, Mm^Xm, Mm^Xm, Xu, Xu, Xu, Xuc, Xuc, Xuc, Xuc, Xuc, Xuc, Xuc, Xuc, Xu, Xu, Qxu, Qxu, Xu, Xuc, Xuc, Xuc, Xu, Ur, Ur, Ur, Uu, Uu, Ur, Uu
