border_size=1
usage=map

Xu, Xu, Xu, Xu, Xu, Xu, Xu, Xu, Xu, Xu, Xu, Xu, Xu, Xu, Xu, Xu, Xu, Xu, Xu, Xu, Xu, Xu, Xu, Xu, Xu, Xu, Xu, Xu, Xu, Xu, Xu, Xu, Xu, Xu, Xu, Xu, Xu, Xu, Xu, Xu, Xu, Xu, Xu, Xu, Xu, Xu, Xu, Xu, Xu, Xu
Xu, Xu, Xu, Xu, Xu, Xu, Xu, Xu, Xu, Xu, Xu, Xu, Xu, Xu, Xu, Xu, Xu, Xu, Xu, Xu, Xu, Xu, Xu, Xu, Xu, Xu, Xu, Xu, Xu, Xu, Xu, Xu, Xu, Xu, Xu, Xu, Xu, Xu, Xu, Xu, Xu, Xu, Xu, Xu, Xu, Xu, Xu, Xu, Xu, Xu
Xu, Xu, Xu, Xu, Xu, Xu, Xu, Xu, Xu, Xu, Xu, Xu, Xu, Xu, Xu, Xu, Ur^Ii, Ur^Ii, Ur^Ii, Xu, Xu, Xu, Xu, Xu, Xu, Xu, Xu, Xu, Xu, Xu, Xu, Xu, Xu, Xu, Xu, Xu, Xu, Xu, Xu, Xu, Xu, Xu, Xu, Xu, Xu, Xu, Xu, Xu, Xu, Xu
Xu, Xu, Xu, Xu, Xu, Xu, Xu, Xu, Xu, Xu, Xu, Xu, Xu, Xu, Xu, Xu, Ur^Dr, 1 Urb, Ur, Xu, Ur^Dr, Xu, Xu, Xu, Xu, Xu, Xu, Xu, Xu, Xu, Xu, Xu, Xu, Xu, Xu, Xu, Xu, Xu, Xu, Xu, Xu, Xu, Xu, Xu, Xu, Xu, Xu, Xu, Xu, Xu
Xu, Xu, Xu, Xu, Xu, Xu, Uh, Xu, Xu, Xu, Xu, Xu, Xu, Xu, Xu, Xu, Xu, Ur^Dr, Uu, Rb, Rb, Uh^Emf, Uh, Xu, Xu, Xu, Xu, Xu, Xu, Xu, Xu, Xu, Xu, Xu, Xu, Xu, Xu, Xu, Xu, Xu, Xu, Xu, Xu, Xu, Xu, Xu, Xu, Xu, Xu, Xu
Xu, Xu, Xu, Xu, Xu, Uh, Xu, Xu, Xu, Xu, Xu, Xu, Xu, Xu, Xu, Xu, Xu, Xu, Xu, Xu, Xu, Rb, Ur, Xu, Cud^Dr, Xu, Xu, Xu, Xu, Xu, Xu, Xu, Xu, Xu, Xu, Xu, Xu, Xu, Xu, Xu, Xu, Xu, Xu, Xu, Xu, Xu, Xu, Xu, Xu, Xu
Xu, Xu, Xu, Xu, Uh^Emf, Uu^Uf, Uue, Uh^Emf, Uu^Emf, Xu, Xu, Xu, Xu, Xu, Xu, Xu, Xu, Xu, Xu, Xu, Xu, Uu^Vu, Rb, Uu, Uu^Em, Cud, Kud, Xu, Xu, Xu, Qxu, Qxu, Qxu, Qxu, Qxu, Xu, Xu, Xu, Xu, Xu, Xu, Xu, Xu, Xu, Xu, Xu, Xu, Xu, Xu, Xu
Xu, Xu, Xu, Xu, Uu^Emf, Uu^Y27, Uu, Rb, Rb, Uu^Emf, Uu, Uu^Dr, Uu^Y27, Xu, Xu, Xu, Xu, Xu, Xu, Xu, Xu, Xu, Rb, Uu, Uu^Em, Cud, Xu, Xu, Xu, Xu, Qxu, Xu, Xu, Qxu, Qxu, Xu, Xu, Xu, Xu, Xu, Xu, Xu, Xu, Xu, Xu, Xu, Xu, Xu, Xu, Xu
Xu, Xu, Xu, Xu, Uu^Emf, Ur^Emf, Xu, Xu, Xu, Uu, Uu, Rb, Rb, Uue, Uu, Xu, Xu, Xu, Xu, Xu, Xu, Uu^Uf, Ur, Ur, Uu^Dr, Xu, Xu, Xu, Xu, Xu, Qxu, Xu, Xu, Xu, Qxu, Qxu, Xu, Xu, Xu, Xu, Xu, Xu, Xu, Xu, Xu, Xu, Xu, Xu, Xu, Xu
Xu, Xu, Xu, Xu, Uue, Rb, Xu, Xu, Xu, Xu, Xu, Xu, Xu, Uu, Uu, Uu, Uu, Xu, Ur^Emf, Xu, Ur, Ur, Uu, Uu, Xu, Xu, Xu, Xu, Xu, Xu, Qxu, Xu, Xu, Xu, Qxu, Qxu, Xu, Xu, Xu, Xu, Xu, Xu, Xu, Xu, Xu, Xu, Xu, Xu, Xu, Xu
Xu, Xu, Xu, Xu, Uue, Uu, Uu^Y26, Xu, Xu, Xu, Xu, Xu, Ur, Ur, Ur, Rb, Rb, Uh, Uu, Rb, Uu, Uu, Uu^Emf, Uu^Dr, Xu, Xu, Xu, Xu, Qxu, Qxu, Qxu, Qxu, Xu, Xu, Qxu, Qxu, Xu, Xu, Xu, Xu, Xu, Xu, Xu, Xu, Xu, Xu, Xu, Xu, Xu, Xu
Xu, Xu, Xu, Uh^Emf, Uu, Rb, Uu^Y27, Uu^Dr, Uu, Uu^Vu, Rb, Rb, Uu, Uu, Xu, Uu^Em, Xu, Uu^Vu, Xu, Uu, Uu^Dr, Uu^Emf, Xu, Xu, Xu, Xu, Xu, Qxu, Qxu, Qxua, Qxua, Qxu, Xu, Xu, Qxu, Qxu, Xu, Xu, Xu, Xu, Xu, Xu, Xu, Xu, Xu, Xu, Xu, Xu, Xu, Xu
Qxu, Xu, Uh^Emf, Uh^Emf, Uu, Rb, Uu, Uu, Ur, Ur, Uu, Uu, Xu, Xu, Xu, Xu, Xu, Xu, Xu, Xu, Xu, Xu, Xu, Xu, Xu, Xu, Xu, Qxu, Qxu, Qxua, Qxu, Qxu, Xu, Xu, Qxu, Qxu, Xu, Xu, Xu, Xu, Xu, Xu, Xu, Xu, Xu, Xu, Xu, Xu, Xu, Xu
Qxu, Qxu, Uh^Emf, Uh^Emf, Uh, Rb, Ur, Uu, Ur, Ur^Esd, Xu, Xu, Xu, Xu, Xu, Xu, Xu, Xu, Uu^Emf, Xu, Xu, Xu, Xu, Xu, Xu, Xu, Xu, Qxu, Xu, Qxu, Xu, Xu, Xu, Xu, Qxu, Qxu, Xu, Xu, Xu, Xu, Xu, Xu, Xu, Xu, Xu, Xu, Xu, Xu, Xu, Xu
Qxu, Qxu, Qxu, Uh^Y27, Uh, Uh, Uu, Ur, Ur, Uu, Xu, Xu, Qxu, Qxu, Ur, Xu, Xu, Uu^Emf, Uu, Uu, Uu^Emf, Uh^Emf, Uh, Xu, Xu, Xu, Xu, Xu, Xu, Xu, Xu, Xu, Xu, Qxu, Qxu, Qxu, Xu, Xu, Xu, Xu, Xu, Xu, Xu, Xu, Xu, Xu, Xu, Xu, Xu, Xu
Xu, Qxu, Xu, Qxu, Qxu, Qxu, Qxu, Ur, Uu, Uu^Y27, Uu^Vu, Xu, Qxu, Ur, Xu, Uu, Uu, Xu, Uu, Uu, Uh, Uu, Uu^Y27, Uue, Uu, Xu, Xu, Xu, Xu, Xu, Xu, Xu, Xu, Qxu, Qxu, Xu, Xu, Xu, Xu, Xu, Xu, Xu, Xu, Xu, Xu, Xu, Xu, Xu, Xu, Xu
Xu, Xu, Xu, Xu, Xu, Qxu, Qxu^Bs/, Ur, Ur, Uu^Emf, Rb, Qxu, Ur, Ur, Xu, Xu, Xu, Uu, Uh^Emf, Uh^Dr, Xu, Xu, Xu, Uh, Qxu, Re, Ur, Qxu, Qxu, Xu, Xu, Xu, Xu, Qxu, Qxu, Xu, Xu, Xu, Xu, Xu, Xu, Xu, Xu, Xu, Xu, Xu, Xu, Xu, Xu, Xu
Xu, Xu, Xu, Xu, Uu^Y27, Ur, Ur, Qxu, Qxu, Qxu, Qxu, Uu, Xu, Xu, Xu, Xu, Xu, Xu, Xu, Xu, Xu, Xu, Xu, Xu, Xu, Uh^Emf, Re, Uh^Emf, Xu, Xu, Xu, Xu, Xu, Qxu, Qxu, Qxu, Xu, Xu, Xu, Xu, Xu, Xu, Xu, Xu, Xu, Xu, Xu, Xu, Xu, Xu
Xu, Xu, Xu, Xu, Uu^Uf, Ur, Qxu, Qxu, Qxu, Xu, Xu, Qxu, Qxu, Xu, Qxu, Xu, Xu, Xu, Qxu, Xu, Qxu, Xu, Xu, Xu, Xu, Xu, Rb, Uh, Xu, Xu, Xu, Xu, Xu, Xu, Qxu, Qxu, Xu, Xu, Xu, Xu, Xu, Xu, Xu, Xu, Xu, Xu, Xu, Xu, Xu, Xu
Xu, Xu, Xu, Xu, Uh, Ur, Xu, Xu, Xu, Xu, Xu, Xu, Xu, Qxu, Xu, Qxu, Qxu, Qxu, Qxu, Qxu, Xu, Qxu, Qxu, Xu, Xu, Xu, Xu, Ur, Rb, Xu, Xu, Xu, Qxu, Qxu, Qxu, Qxu, Xu, Xu, Xu, Xu, Xu, Xu, Uh, Xu, Ur, Re^Y26, Ur, Xu, Xu, Xu
Xu, Xu, Xu, Xu, Rb, Ur, Xu, Xu, Xu, Xu, Xu, Xu, Xu, Xu, Xu, Xu, Qxu, Qxu, Uu, Xu, Uu^Uf, Xu, Qxu, Xu, Xu, Xu, Xu, Uh, Uu, Uh^Emf, Xu, Xu, Xu, Qxu, Xu, Xu, Xu, Xu, Xu, Xu, Uh, Uu^Y26, Dd, Re, Uu, Uu, Ur, Ur, Uue, Gg
Xu, Xu, Uu^Vu, Ur, Rd, Uu, Xu, Xu, Xu, Xu, Xu, Xu, Uh^Y27, Uh, Uh, Uh, Uu, Qxu, Qxu^Bs/, Ur, Uu, Dd, Ur, Qxu, Qxu, Xu, Xu, Xu, Ur, Uh^Y27, Xu, Xu, Xu, Qxu, Xu, Xu, Xu, Xu, Xu, Xu, Uh, Uu^Y27, Re, Uu, Xu, Xu, Xu, Ur, Uue, Gg
Xu, Xu, Uu^Uf, Rb, Xu, Uh, Qxu, Xu, Xu, Xu, Xu, Xu, Xu, Uu, Uu, Ur, Ur, Ur, Qxu, Uu, Xu, Ur, Uu, Ur, Uu, Xu, Xu, Xu, Qxu, Uu, Xu, Xu, Xu, Qxu, Qxu, Xu, Xu, Xu, Xu, Uu^Emf, Uu, Uue, Re, Uu^Uf, Xu, Xu, Xu, Xu, Xu, Gg
Xu, Xu, Uh, Rb, Uu, Uh, Xu, Qxu, Qxu, Xu, Xu, Xu, Uu, Uu, Rb, Rb, Xu, Xu, Qxu, Xu, Xu, Xu, Xu, Ur, Uu, Xu, Xu, Xu, Qxu, Uu, Uu, Xu, Xu, Xu, Xu, Qxu, Qxu, Xu, Xu, Xu, Xu, Dd^Y26, Re, Uu^Uf, Xu, Xu, Xu, Xu, Xu, Xu
Xu, Xu, Xu, Rb, Ur, Xu, Uue, Xu, Qxu, Qxu, Qxu, Xu, Rb, Ur, Xu, Xu, Xu, Xu, Qxu, Qxu, Xu, Xu, Qxu, Ur, Ur, Xu, Xu, Xu, Qxu, Xu, Ur, Xu, Xu, Xu, Xu, Xu, Qxu, Xu, Xu, Xu, Xu, Uu, Ur, Re, Uh^Y27, Xu, Xu, Xu, Xu, Xu
Xu, Xu, Xu, Uu^Y22, Uu^Y26, Rb, Rd, Rb, Ur, Uu, Ur, Ur, Uu, Uu^Y22, Xu, Xu, Xu, Xu, Xu, Qxu, Xu, Xu, Xu, Qxu, Uu, Ur, Ur, Uu, Ur, Qxu, Qxu, Ur, Uu^Uf, Qxu, Qxu, Qxu, Xu, Xu, Xu, Xu, Xu, Xu, Uu^Uf, Re, Ur, Uh, Xu, Xu, Xu, Xu
Xu, Xu, Xu, Xu, Xu, Uu^Y27, Xu, Uu, Uu^Y26, Ur, Uu^Uf, Uu, Xu, Xu, Xu, Xu, Qxu, Qxu, Qxu, Qxu, Xu, Xu, Xu, Xu, Xu, Uu, Qxu, Qxu, Qxu, Ur, Ur, Ur, Ur^Emf, Uu^Emf, Uu^Uf, Qxu, Qxu, Xu, Xu, Xu, Xu, Xu, Uu, Ur, Ur, Xu, Xu, Xu, Xu, Xu
Qxu, Qxu, Qxu, Xu, Xu, Xu, Xu, Xu, Xu, Xu, Xu, Xu, Xu, Xu, Xu, Xu, Qxu, Qxu, Xu, Qxu, Qxu, Xu, Qxu, Qxu, Qxu, Xu, Xu, Xu, Xu, Qxu, Uu^Emf, Re, Ur, Re, Ur, Uue^Y27, Uu, Qxu, Uu^Emf, Uu^Emf, Ur, Uu^Uf, Ur, Re, Uu^Uf, Xu, Xu, Xu, Xu, Xu
Qxu, Qxua, Qxu, Qxu, Qxu, Xu, Xu, Xu, Xu, Xu, Xu, Xu, Xu, Xu, Xu, Xu, Xu, Qxu, Qxu, Xu, Xu, Qxu, Xu, Xu, Qxu, Xu, Qxu, Xu, Xu, Qxu, Xu, Uu^Emf, Xu, Uu, Uu^Vu, Re, Uu, Ur, Ur, Ur, Uu, Ur, Uh, Dd, Uu^Emf, Xu, Xu, Xu, Xu, Xu
Qxu, Qxua, Qxu, Qxu, Qxu, Qxu, Qxu, Xu, Qxu, Xu, Qxu, Xu, Qxu, Xu, Qxu, Xu, Qxu, Xu, Xu, Qxu, Xu, Xu, Xu, Xu, Qxu, Qxu, Xu, Qxu, Qxu, Qxu, Xu, Xu, Xu, Xu, Xu, Xu, Xu, Uh, Xu, Uu^Uf, Xu, Xu, Xu, Xu, Xu, Xu, Xu, Xu, Xu, Xu
Qxu, Qxua, Qxu, Qxu, Qxu, Qxu, Qxu, Qxu, Qxu, Qxu, Qxu, Qxu, Qxu, Qxu, Qxu, Qxu, Xu, Qxu, Qxu, Qxu, Xu, Xu, Xu, Xu, Xu, Xu, Xu, Xu, Xu, Xu, Xu, Xu, Xu, Xu, Xu, Xu, Xu, Xu, Xu, Xu, Xu, Xu, Xu, Xu, Xu, Xu, Xu, Xu, Xu, Xu
Qxu, Qxu, Qxu, Qxu, Qxu, Qxu, Qxu, Qxu, Qxu, Qxu, Qxu, Qxu, Qxu, Qxu, Qxu, Xu, Xu, Xu, Xu, Xu, Xu, Xu, Xu, Xu, Xu, Xu, Xu, Xu, Xu, Xu, Xu, Xu, Xu, Xu, Xu, Xu, Xu, Xu, Xu, Xu, Xu, Xu, Xu, Xu, Xu, Xu, Xu, Xu, Xu, Xu
