border_size=1
usage=map

Mm^Xm, Mm^Xm, Mm^Xm, Mm^Xm, Mm^Xm, Mm^Xm, Mm^Xm, Mm^Xm, Mm^Xm, Mm^Xm, Mm^Xm, Mm^Xm, Mm^Xm, Xos, Xos, Xol, Xol, Xos, Xos, Xos, Xos, Xos, Xos, Xos, Xol, Xos, Xos, Xos, Xos, Xu, Xu, Xu, Xu, Xu, Xu, Xu, Xu, Xuce, Ss, Wwg, Wog, Sm^Emf, Ss, Ss, Rb^Y7, Ss, Rb^Y27, Xos, Xos, Xos, Xos, Xos, Xos, Xos, Xos, Xos
Mm^Xm, Mm^Xm, Mm^Xm, Mm^Xm, Mm^Xm, Mm^Xm, Mm^Xm, Mm^Xm, Mm^Xm, Mm^Xm, Mm^Xm, Mm^Xm, Mm^Xm, Xos, Xos, Xol, Xos, Xos, Xos, Xos, Xos, Xos, Xos, Xos, Rrc^yyLB, Xos, Xol, Xos, Xos, Xu, Dd^Dc, Xu, Xu, Xu, Xu, Xu, Xu, Xuce, Ss, Wwf, Wwg, Sm, Sm, Ss, Rp, Rp, Ur, Uu, Xol, Xol, Urb, Urb^Emf, Ur, Xos, Xos, Xos
Mm^Xm, Mm^Xm, Mm^Xm, Mm^Xm, Mm, Mm^Xm, Mm, Mm^Xm, Mm^Xm, Mm^Xm, Mm^Xm, Mm^Xm, Mm^Xm, Xos, Xos, Xol, Xos, Xos, Xos, Xos, Xos, Xos, Rrc^yyLB, Rr, Rr, Rr, Rrc^yyLB, Xos, Xos, Xu, Xu, Xu, Xu, Xu, Xu, Xu, Xuce, Xuce, Ss, Wog, Wwg, Wwf, Wwg^Bw/r, Wwg^Bw/, Wwf^Dr, Rp, Xol, Ur^y/W3, Ur, Urb, Urb, Urb, Rb, Urb, Ur, Xos
Mm^Xm, Mm^Xm, Mm, Mm, Mm, Mm, Hh^Fp, Mm, Mm^Xm, Mm^Xm, Mm^Xm, Mm^Xm, Mm^Xm, Xos, Xos, Xos, Xos, Xos, Xos, Xos, Rrc^yyLB, Rr, Rr, Rr, Rrc^Ii, Rr, Rr, Rr, Rrc^yyLB, Xos, Xos, Xu, Xu, Xu, Xuce, Xuce, Ss, Ss, Sm, Wwf, Wwg, Wwg, Ss, Wwf, Xos, Xol, Urb, Ur, Ur, Urb, Urb, Urb, Urb, Urb, Rb, Xos
Mm, Mm, Mm, Hh^Fp, Mm, Mm, Hh^Vu, Mm, Mm, Mm^Xm, Mm^Xm, Mm^Xm, Mm^Xm, Xos, Xos, Xos, Xos, Xos, Xos, Xos, Xos, Rr, Rrc^yyLB, Rr, Rr, Rr, Rr, Rr, Xos, Xos, Xol, Xu, Xuce, Xuce, Sm^Emf, Sm, Sm, Sm, Rb, Wwg^Bw/r, Wwf^Y27, Rb, Xos, Xos, Rb, Urb, Urb, Ur, Ur, Ur, Xos, Uu, Ur, Urb, Ur, Xos
Mm, Mm, Cog^Y27, Cog, Cog^Y22, Hh^Fp, Hh^Fp, Mm, Hh^Fp, Mm, Mm, Mm^Xm, Mm^Xm, Mm^Xm, Mm^Xm, Xol, Xol, Xos, Xos, Xos, Xos, Xos, Xos, Rr, Rrc^yyLB, Rr, Rr, Rr, Rr, Xol, Ss, Xuce, Zw, Ss, Wwf, Ss, Wwf^Bw/r, Rb, Ss, Wog, Wwg, Sm, Xos, Xos, Ur, Urb, Urb, Ur, Uu^y/W3, Xol, Uu, Xol, Uu^y\W3, Ur, Xos, Xos
Mm, Mm, Cog, 2 Co^Kov, Cog, Hh^Fp, Hh^Fp, Hh^Fp, Hh, Hh^Fp, Hh^Fp, Mm, Mm, Mm^Xm, Mm^Xm, Mm^Xm, Mm^Xm, Xol, Xol, Xos, Xos, Xos, Xos, Xos, Xos, Xos, Xol, Rr, Rr, Zw, Zw, Zw^Y2, Rp, Rb^Y26, Wwf^Bw/r, Ss^Bw/r, Wwg, Sm, Ss, Sm, Wwg, Rb^Y26, Xos, Xos, Urb^Emf, Urb, Xol, Xol, Ur, Ur, Rb, Ur^Y22, Ur, Xol, Xol, Xos
Hh^Fp, Mm, Hh^Fp, Cog^Y22, Hh^Fp, Rb, Hh^Fp, Mm, Hh, Mm, Hh^Fp, Mm, Mm, Mm, Mm^Xm, Mm^Xm, Mm^Xm, Mm^Xm, Mm^Xm, Xol, Xol, Xos, Xos, Xos, Xos, Xol, Ss^Y27, Zw, Zw^Y2, Rp, Rp, Rp, Zw, Rp, Rb^Y27, Wwg, Wwg, Sm, Ss, Sm, Wog, Sm, Xos, Xos, Xos, Xos, Uh, Uu^Vu, Uu, Ur, Ur, Ur, Uu, Uh, Xu, Xos
Hh^Fp, Gll^Fp, Hh^Fp, Mm, Md, Re, Rb, Mm, Mm, Hh^Vu, Gd^Fmw, Hh^Fp, Mm, Mm, Mm, Mm^Xm, Mm^Xm, Mm^Xm, Mm^Xm, Mm^Xm, Mm^Xm, Xos, Xos, Xos, Xuc, Xuc, Xuc, Ss, Ss, Zw, Zw, Rp, Ss, Zw, Sm, Wwf, Ss, Ss, Rb^Y7, Sm, Wwg, Sm, Xos, Xos, Uh^Emf, Qxe, Uu^Vu, Uu, Re, Rb, Cud, Rb, Uh, Uu^Uf, Xu, Xu
Mm, Hh^Fp, Mm, Gll^Vu, Hh^Fp, Gll^Fp, Rb, Hh^Fp, Hh, Hh^Fp, Hh^Fp, Hh^Fp, Hhd^Fmw, Mm, Mm, Mm, Mm, Mm^Xm, Mm^Xm, Mm^Xm, Mm^Xm, Mm^Xm, Mm^Xm, Xu, Xu, Xu, Xu, Xuc, Xuc, Ss, Ss, Ss, Wwf, Rb^Y27, Ss, Wwf, Ss, Sm, Wwf, Wwg, Sm, Ss, Xos, Xos, Uh^Vu, Qxu, Qxu, Ur, Qxu, Cud, 4 Kud, Cud, Cud, Uu^Y22, Xu, Xu
Hh, Gll^Fp, Mm, Hh^Fp, Gll^Fp, Hh, Hh^Vu, Re, Gll, Gs, Gs, Hh^Fp, Hh^Fp, Mm, Mm, Hh^Fp, Mm, Mm, Mm, Mm^Xm, Mm, Mm^Xm, Mm^Xm, Mm^Xm, Mm^Xm, Xu, Xu, Xuc, Xuc, Xuc, Xuc, Sm^Emf, Sm^Emf, Rb^Y22, Wwf, Wwf, Wwg, Wwf, Wwg, Wwg, Ss, Ss, Xu, Xos, Qxe, Uu, Ur, Qxu, Uu, Cud, Cud, Cud, Xuc, Xu, Xu, Xu
Hh, Mm, Gll^Fp, Gll^Fp, Hh^Fms, Hh^Fp, Hh^Fdw, Gg, Gg, Gll, Gs, Gs, Hh^Fp, Hhd^Fmw, Hh^Fp, Hh^Fp, Mm, Mm, Mm, Mm, Hh^Fp, Mm, Mm, Mm^Xm, Mm^Xm, Mm^Xm, Mm^Xm, Xu, Xu, Xu, Xuc, Xuc, Xuc, Ss, Ss, Wwg, Wwg, Wwg, Ss, Rb^Emf, Xu, Xu, Xu, Xu, Qxu, Re, Ur, Qxu^Bh/, Uu, Rb, Qxe, Uu, Rd, Xu, Uh, Xu
Mm, Gll^Fp, Gll^Fp, Gll^Fp, Hh^Fp, Gll^Fp, Gs^Fp, Hh^Fp, Gll^Fp, Gll, Hh^Fms, Hh^Fp, Gs, Gll^Fp, Hh^Fp, Hh^Fp, Hh^Fp, Hhd^Vu, Hh^Fp, Mm, Hh^Fp, Mm, Hh^Fp, Mm, Mm, Mm^Xm, Mm^Xm, Mm^Xm, Mm^Xm, Xu, Xu, Xuc, Xuc, Xuc, Wog, Wwg, Ss, Sm^Emf, Xu, Xu, Xu, Xu, Xu, Xu, Qxe, Ur, Uu, Qxe, Qxu, Uu, Xu, Qxu, Qxu, Rb, Uu^Emf, Xu
Mm, Mm, Hh, Gll^Fp, Gs^Fp, Gs^Fp, Gs^Fp, Hh^Fp, Gs^Fp, Gs, Hh^Fms, Hh, Hh^Fp, Gll^Fp, Gll^Fp, Hh^Fp, Hh^Fp, Mm, Hh^Fp, Mm, Hh^Fp, Hh^Fp, Mm, Mm, Mm, Mm, Mm, Mm^Xm, Mm^Xm, Mm^Xm, Mm^Xm, Xu, Xu, Xuc, Wog, Wog, Wog, Xu, Xu, Xu, Xu, Xu, Xu, Xu, Uu, Re, Re, Xu, Xu, Xu, Xu, Xu, Xu, Xu, Xu, Xu
Mm, Hh^Fp, Hh^Fp, Hh, Gs^Fp, Gs^Fp, Gg, Hh^Fp, Gll^Fp, Gg, Hh^Fms, Gll^Fp, Hh^Fp, Gll^Fp, Gll^Fp, Gll^Fp, Gll^Fp, Hh^Fp, Mm, Mm, Hh^Es, Hhd^Fmw, Hh^Fp, Mm, Mm, Mm, Mm, Mm^Xm, Mm^Xm, Mm^Xm, Mm^Xm, Mm^Xm, Mm^Xm, Xuc, Wog^Xo, Wog, Wog^Xo, Xu, Xu, Xu, Xu, Xu, Rd, Uu, Uu^Qov, Rb, Ur, Uu, Uue, Uh^Emf, Rd, Xu, Uh^Emf, Xu, Xu, Xu
Mm, Hh^Fp, Hh^Es, Hh^Fp, Ds, Gg, Gs^Fp, Gs^Fp, Gll^Fp, Re, Gg, Gll^Fp, Gll^Fp, Hh, Hh, Gll^Fp, Gll^Fp, Gll^Fp, Mm, Mm, Mm, Mm, Mm, Mm, Mm, Mm, Mm, Mm, Mm, Mm, Mm^Xm, Mm^Xm, Mm^Xm, Mm^Xm, Wog, Wog^Xo, Wog, Xuc, Xu, Xu, Xu, Uu^Vu, Uu^Dr, Ur, Rb, Rb^Qov, Ur, Uu, Uu, Ur, Ur, Rb, Uh^Dr, Xu, Xu, Xu
Hh^Fdw, Hh, Gg, Gg, Gg, Gs^Fp, Gg, Gg, Gs^Fp, Hh^Fp, Gs^Fp, Gg, Gs, Ds, Hh^Fp, Hh, Hh^Fp, Hh^Fp, Hh, Hh, Hh^Fp, Hh^Fp, Mm, Mm, Mm, Mm, Hhd^Fmw, Mm, Mm, Mm, Hh^Fp, Mm^Xm, Mm^Xm, Mm^Xm, Wog, Wog, Wog, Mm^Xm, Mm^Xm, Xu, Xu, Xu, Xu, Uh^Y26, Uu^Uf, Uh^Y27, Xu, Uu, Re, Ur, Uh^Y26, Uh, Xu, Xu, Xu, Xu
Hh, Gg, Gg, Gg, Gg, Gs^Fp, Gs^Fp, Gg, Gs^Fp, Gs^Fp, Gs^Fp, Gs^Fp, Gs, Ds, Gs, Gs, Gs, Gs, Gs, Hh, Hh^Fp, Gll^Fp, Gll^Fp, Mm, Mm, Mm, Hh^Vc, Mm, Mm, Mm, Hh^Fp, Mm^Xm, Mm^Xm, Mm^Xm, Wwg, Wog, Wwg, Mm^Xm, Mm^Xm, Mm^Xm, Mm^Xm, Xu, Xu, Xu, Xu, Xu, Xu, Xu, Rb, Ur, Rb, Xu, Xu, Xu, Xu, Xu
Mm, Gg, Gg, Gg, Gg, Gg, Gs^Fp, Hh^Fp, Gs^Fp, Gs^Fp, Gs^Fp, Gs^Fp, Gs^Fp, Gs, Rb, Rb, Gs, Rb, Gs, Gs, Gg, Gll^Fp, Gll^Fp, Mm, Mm, Hh^Fdw, Hh^Fp, Gs^Fp, Hh^Fp, Mm, Hh^Fp, Hh^Fp, Hh^Fp, Hh^Fp, Wwg, Wog, Wwg, Md, Mm^Xm, Mm^Xm, Mm^Xm, Mm^Xm, Mm^Xm, Xu, Xu, Xu, Uu, Uu, Rb, Ur, Xu, Xu, Xu, Xu, Xu, Xu
Hh, Hh^Fp, Gg, Gg, Gg, Gs^Fp, Gs^Fp, Gs^Fp, Hh^Fp, Gs^Fp, Gs^Fp, Gs^Fp, Gs^Fp, Rb, Gs^Fp, Hh^Fp, Hh^Fp, Hh, Hh, Rb, Rb, Gs^Fp, Gs^Fp, Hh^Fms, Gs^Fp, Hh^Fdw, Gs^Fp, Gs^Fp, Gs^Fp, Hh^Fp, Hh^Fp, Hh^Fdw, Hh^Fdw, Hh^Fp, Wwg, Wog, Wwg, Hh, Mm, Mm^Xm, Mm^Xm, Mm^Xm, Mm^Xm, Mm^Xm, Hh, Rb, Rb, Ur, Xu, Xu, Xu, Xu, Xu, Xu, Xu, Xu
Mm, Hh^Fp, Gg, Gg, Gs^Fp, Hh^Fdw, Gs^Fp, Gs^Fp, Hh^Fp, Hh^Fp, Gg^Em, Hh^Fp, Gs, Rb, Hh^Fp, Hh^Vhhr, Hh^Fp, Hh^Fp, Gs^Fp, Gs^Fp, Gg, Rb, Gs^Fp, Gs^Fp, Gs^Fp, Gll^Fp, Gs^Fp, Gs^Fp, Gs^Fp, Hh^Fp, Ss, Ss, Wwg, Wwg, Wog, Wog, Wwf, Hh, Hh^Fdw, Md, Hh^Vu, Md, Hh^Fdw, Hh, Gg, Rb, Hh, Xu, Xu, Xu, Xu, Xu, Xu, Xu, Xu, Xu
Hh^Fp, Hh, Gg, Gg, Gll^Fp, Gg^Es, Gll^Fp, Gs^Fp, Gs^Fp, Hh^Fp, Hh^Fp, Hh^Fp, Rb, Gs, Hh^Fp, Hh^Fp, Mm, Mm, Hh^Fp, Hh^Fp, Gs^Fp, Rb, Gg, Gs^Fp, Gs^Fp, Gs^Fp, Gs^Fp, Gs^Fp, Ss, Ss^Fdw, Wwf, Wwf, Wwg, Wwg, Wog, Wwf, Ss, Ss, Ss^Fdw, Ss^Fdw, Ss, Hh, Gg, Gs, Re, Gg, Hh, Md^Xm, Mm^Xm, Xu, Xu, Xu, Xu, Xu, Xu, Xu
Mm, Hh^Fp, Gll^Fp, Gg^Es, Gg^Efm, Gs, Ds, Gg^Em, Hh^Fmw, Hh^Fdw, Hh^Fdw, Gs, Gs, Hh^Fp, Hh^Fp, Hh^Fp, Hh^Fp, Mm, Mm, Gs^Fp, Hh^Fp, Rb, Rb, Gs, Gg, Gs^Fp, Gg^Fdw, Gs^Fp, Dd^Fdw, Wwf, Wwf, Wwg, Wog, Wog, Wwg, Wwf, Ss, Sm, Ss, Sm, Rb, Gg, Re, Re, Gs, Gs^Fdw, Md, Mm^Xm, Mm^Xm, Mm^Xm, Mm^Xm, Xu, Xu, Xu, Xu, Xu
Mm, Hh^Fp, Hh, Gll^Fp, Gg, Gs, Gll^Fp, Gg, Gs^Fp, Gs^Fp, Rb, Rb, Gg^Em, Gll^Fp, Hh^Fp, Mm, Md^Xm, Mm, Mm, Mm, Mm, Hh^Fp, Gll^Fp, Rb, Rb, Rb, Gg, Chr^Fdw, Wwf, Wwf, Khr, Dd^Fdw, Dd, Wwg, Wwf, Wwf, Ss^Fdw, Ss^Fdw, Ss^Fdw, Rb, Gs, Gg, Re, Re, Gs, Hh, Md, Mm^Xm, Md, Mm^Xm, Mm^Xm, Mm^Xm, Mm^Xm, Xu, Xu, Xu
Mm, Mm, Hh, Gll^Fp, Gll^Fp, Gll^Fp, Ce, Ce, Ce, Gg, Rb, Gg^Es, Hh^Fp, Hh^Fp, Mm, Mm, Md^Xm, Md^Xm, Md^Xm, Md^Xm, Mm, Gll^Fp, Gll^Fp, Gll^Fp, Gg, Re, Gs, Rb, Wwf, Wwf^Y26, Chr, Chr^Dr, 3 Khr, Chw, Wwf^Dr, Wwf, Ss, Ss, Gg, Gg, Re, Re, Gs, Re, Gs, Hh^Fdw, Mm, Md, Md, Md, Mm^Xm, Mm^Xm, Mm^Xm, Mm^Xm, Mm^Xm, Xu
Uue, Mm, Gg, Gs, Gll^Fp, Gll^Fp, Ce, 1 Ke, Ce, Rb, Gg, Gg, Gll^Fp, Hh^Fp, Hh^Fp, Mm, Mm, Md^Xm, Md^Xm, Md^Xm, Mm, Gll^Fp, Gll^Fp, Gll^Fp, Rb, Gg, Gg, Chr^Fdw, Wwf^Y27, Wwf, Khr^Fdw, Uh^Y26, Dd^Fdw, Chr^Fdw, Wwf, Wwf, Rb, Gg, Gg, Gs, Re, Gs, Re, Re, Gg, Gs, Hh, Mm, Mm, Md, Md, Mm^Xm, Mm^Xm, Mm^Xm, Mm^Xm, Mm^Xm
Uue, Uue, Rb, Gg, Rb, Gg, Gg^Efm, Ce, Gg, Gs, Gs, Gll^Fp, Gll^Fp, Gll^Fp, Hh^Fp, Mm, Mm, Md^Xm, Md^Xm, Md^Xm, Mm, Hh^Fp, Hh^Fp, Gs^Fp, Gs^Fp, Gg, Rb, Gll^Fp, Wwg, Wwf, Dd, Dd, Wwg, Wwf, Wwf, Rb, Gg, Rb, Re, Re, Gs, Gs, Gg, Gg, Gd, Gs, Gs, Hh^Fp, Hh^Fp, Hh^Fp, Hh^Fp, Md, Mm^Xm, Mm^Xm, Mm^Xm, Mm^Xm
Mm, Mm, Hh, Rb, Gg, Gg, Gg, Gg, Gg^Efm, Gg, Gll^Fp, Gll^Fp, Gll^Fp, Gll^Fp, Hh^Fp, Hh^Vhhr, Mm, Md^Xm, Md^Xm, Mm, Mm, Mm, Mm, Hh^Fp, Hh^Fp, Gs^Fp, Gs^Fp, Gll^Fp, Wwg, Wwg, Wwg, Wwg, Wwf, Wwf, Gg^Fdw, Chr, Gs, Gg, Gg, Gg, Gs, Gs, Gg, Gd, Gs, Gd, Gs, Hh, Mm, Mm, Hh^Fp, Md, Hh^Vu, Mm^Xm, Mm^Xm, Mm^Xm
Mm, Mm, Mm, Hh, Hh^Fp, Gs, Gg, Gs, Gg, Gg, Gll^Fp, Gll^Fp, Hh^Fp, Gll^Fp, Hh, Hh^Fp, Mm, Md^Xm, Md^Xm, Mm, Mm, Mm, Hh, Hh^Fp, Hh^Fp, Rp^V26, Rb, Gs^Fp, Wwg, Ww, Wwg, Wwg, Wwf, Rb, Ss, Ss^Fdw, Rb, Gg, Rb, Gg, Gg, Gg, Gs, Gs, Gg, Rp^Es, Gs, Hh^Fdw, Hh^Fdw, Hh^Fp, Hh^Fp, Hh^Fp, Md, Mm^Xm, Mm^Xm, Mm^Xm
Mm, Mm, Mm, Mm, Mm, Hh^Fp, Hh^Fp, Gs^Fp, Gs^Fp, Gg, Gs^Fp, Gll^Fp, Hh^Fp, Gg, Hh, Mm, Md^Xm, Md^Xm, Md^Xm, Md^Xm, Mm, Mm, Mm, Hh, Mm, Hh^Fp, Ss, Ss, Wwg, Ww, Ww, Wwg, Wwg, Gg^Vhs, Ss, Ss, Gg^Fdw, Ss, Gg^Fdw, Ss, Ss, Gg, Gg, Gg, Rb, Gs, Hh, Rd^Vhhr, Mm, Mm, Md, Hh^Fp, Hh^Fp, Mm, Mm^Xm, Mm^Xm
Mm, Mm, Mm, Mm, Mm, Mm, Mm, Mm, Mm, Mm, Mm, Mm, Mm, Mm, Mm, Mm, Md^Xm, Md^Xm, Mm, Md^Xm, Mm, Hh^Fp, Mm, Gll^Fp, Mm, Mm, Ss, Ss, Ss, Wwg, Wwg, Ww, Ww, Wwrg, Ww, Ss, Ss, Ss^Fdw, Ss^Es, Sm, Ss, Ss, Ss, Rb, Hh^Fdw, Hh, Hh, Mm, Md, Md, Md, Hh^Fp, Hh^Fp, Hh^Fp, Md, Mm^Xm
